0
11111111111111111111
10000000000000000001
10000000000000000001
10000000000000000001
10000000000000000001
10000000000000000001
10000000000000000001
10000000000000000001
10000000000000000001
10000000000000000001
10000000000000000001
11111111111111111111
1.5
22222222222222222222
21111111111111111112
21111111111111111112
21111111111111111112
21111111111111111112
21111111111111111112
21111111111111111112
21111111111111111112
21111111111111111112
21111111111111111112
21111111111111111112
22222222222222222222
4
22222222222222222222
20000000000000000002
20000000000000000002
20000000000000000002
20000333300000000002
20000000000000000002
20000000000000000002
20000000000000000002
20000000000000000002
20000000000000000002
20000000000000000002
22222222222222222222
6
11111111111111111111
10100000000000000001
10101110000000000001
10010101000000000001
10001110100000000001
10000101110000000001
10000010101000000001
10000001110100000001
10000000101110000001
10000000001010100001
10000000000010101001
11111111111111111011
800
00000000000000000000
00000000000000000000
00000000000000000000
00000000000000000000
00000000000000000000
00000000000000000000
00000000000000000000
00000000000000000000
00000000000000000000
00000000000000000000
00000000000000000000
00000000000000000000
